00030000000000000000000000000
00010000000000000000000000000
00010000000000000000000000000
00011111111111111111100000000
00000000000000000000100000000
00111111111111111111100000000
00100000000000000000000000000
00111110000000000000000000000
00000010000000000000000000000
00000020000000000000000000000
00000000000000000000000000000
00000000000000000000000000000
00000000000000000000000000000
00000000000000000000000000000