0003000000000000000000000000
0001000000000000000000000000
0001000000000000000000000000
0001111111111111111110000000
0000000000000000000010000000
0011111111111111111110000000
0010000000000000000000000000
0011111000000000000000000000
0000001000000000000000000000
0000002000000000000000000000
0000000000000000000000000000
0000000000000000000000000000
0000000000000000000000000000
0000000000000000000000000000
0000000000000000000000000000
0000000000000000000000000000