0000000000000000000000000000
0001111111111111111111111000
0001000000000000000000001000
0001000111111111000000001000
0001000100000001000000001000
0001000100000001000000001000
0001000100001111000000001000
0001000100001000011100001000
0001001100001120010100001000
0001001000000000010100001000
0001001000000000010100001000
0001001111111111110100001000
0001000000000000000100001000
0001111111111111111100001000
0000000000000000000000001000
0000000000000000000000003000