000300000000000000000000
000100000000000000000000
000100000000000000000000
000111111111111111111000
000000000000000000001000
001111111111111111111000
001000000000000000000000
001111100000000000000000
000000100000000000000000
000000200000000000000000